Brandon	Bennett	bbennett0@nature.com
Amy	Thomas	athomas1@aboutads.info
Joyce	Coleman	jcoleman2@google.nl
Samuel	Day	sday3@usnews.com
Aaron	Moreno	amoreno4@a8.net
Katherine	Carr	kcarr5@whitehouse.gov
Jean	Wilson	jwilson6@vimeo.com
Jack	Garcia	jgarcia7@imdb.com
Shirley	Knight	sknight8@army.mil
Linda	Riley	lriley9@behance.net
Joe	Meyer	jmeyera@psu.edu
Clarence	Marshall	cmarshallb@surveymonkey.com
Albert	Green	agreenc@360.cn
Alan	Young	ayoungd@alexa.com
Amanda	Alexander	aalexandere@wired.com
Carlos	Warren	cwarrenf@dailymail.co.uk
Laura	Campbell	lcampbellg@squidoo.com
Teresa	Freeman	tfreemanh@xing.com
Robin	Brown	rbrowni@cornell.edu
Gloria	Boyd	gboydj@csmonitor.com
Virginia	Bennett	vbennettk@pen.io
Marilyn	Day	mdayl@mail.ru
Ann	Hansen	ahansenm@devhub.com
Carl	Daniels	cdanielsn@nasa.gov
Adam	Robinson	arobinsono@mit.edu
Anthony	Ford	afordp@themeforest.net
Marilyn	Long	mlongq@liveinternet.ru
Timothy	Hart	thartr@freewebs.com
Scott	Lynch	slynchs@sciencedirect.com
Karen	Allen	kallent@webmd.com
Jane	Stewart	jstewartu@springer.com
Gerald	Schmidt	gschmidtv@wordpress.org
Sarah	Simpson	ssimpsonw@weibo.com
Judy	Carroll	jcarrollx@nasa.gov
Christopher	Banks	cbanksy@dmoz.org
Larry	Howard	lhowardz@wordpress.org
Philip	Hughes	phughes10@clickbank.net
Janet	Hayes	jhayes11@vistaprint.com
Charles	Cook	ccook12@unesco.org
Anthony	Ray	aray13@pen.io
Janet	Dunn	jdunn14@etsy.com
Gerald	Smith	gsmith15@nih.gov
Jason	Porter	jporter16@rakuten.co.jp
Frances	Ortiz	fortiz17@yale.edu
Virginia	Perry	vperry18@etsy.com
Dennis	Russell	drussell19@elegantthemes.com
Linda	Green	lgreen1a@bravesites.com
Virginia	Gray	vgray1b@pcworld.com
Justin	Sanchez	jsanchez1c@kickstarter.com
Susan	Wood	swood1d@vk.com
Shirley	King	sking1e@wix.com
George	Reynolds	greynolds1f@g.co
Raymond	Lopez	rlopez1g@sourceforge.net
Julie	Morris	jmorris1h@slideshare.net
Anthony	Medina	amedina1i@intel.com
Jose	Ellis	jellis1j@dmoz.org
Debra	Scott	dscott1k@huffingtonpost.com
Louis	Riley	lriley1l@prweb.com
Betty	Brown	bbrown1m@rediff.com
Thomas	Carr	tcarr1n@symantec.com
Ryan	Chavez	rchavez1o@g.co
Ashley	Graham	agraham1p@facebook.com
Emily	Graham	egraham1q@booking.com
Steven	West	swest1r@gizmodo.com
Steve	Foster	sfoster1s@lycos.com
Juan	Turner	jturner1t@census.gov
Mildred	Pierce	mpierce1u@usnews.com
Steven	Allen	sallen1v@washingtonpost.com
Cynthia	Turner	cturner1w@quantcast.com
Doris	Medina	dmedina1x@qq.com
Wayne	Richardson	wrichardson1y@vk.com
Howard	Brown	hbrown1z@guardian.co.uk
Sharon	Richardson	srichardson20@parallels.com
Ashley	Johnson	ajohnson21@eepurl.com
Matthew	Wallace	mwallace22@uiuc.edu
Karen	Peters	kpeters23@moonfruit.com
Jennifer	Green	jgreen24@google.com.hk
Patrick	Peters	ppeters25@miibeian.gov.cn
Bonnie	Lee	blee26@pbs.org
Jacqueline	Welch	jwelch27@salon.com
Phyllis	Wells	pwells28@tripod.com
Bruce	Fields	bfields29@biblegateway.com
Jean	Welch	jwelch2a@blogs.com
Jimmy	Harvey	jharvey2b@rakuten.co.jp
Virginia	Hunt	vhunt2c@sitemeter.com
Bonnie	Meyer	bmeyer2d@squarespace.com
Robin	Martinez	rmartinez2e@salon.com
Eric	Parker	eparker2f@weebly.com
Kathy	Hanson	khanson2g@patch.com
Keith	Powell	kpowell2h@tinypic.com
Jeremy	Moreno	jmoreno2i@etsy.com
Tina	Dixon	tdixon2j@soup.io
Shirley	Campbell	scampbell2k@gizmodo.com
Jean	Henry	jhenry2l@edublogs.org
Michelle	Hamilton	mhamilton2m@artisteer.com
Rose	Richardson	rrichardson2n@istockphoto.com
Louis	Lawson	llawson2o@ibm.com
Annie	Fowler	afowler2p@youku.com
Earl	Dunn	edunn2q@yahoo.co.jp
Terry	Robertson	trobertson2r@huffingtonpost.com